SessionID,STUDENTID,SUBJECTID,FirstCA,SecondCA,MIDTERM,EXAM,TOTAL,GRADE
AM002324,AMS0001,1,6,10,13,45,74,A
AM002324,AMS0002,1,10,5,18,5,38,F
AM002324,AMS0003,1,3,3,14,43,63,B
AM002324,AMS0004,1,0,6,19,8,33,F
AM002324,AMS0005,1,3,4,13,8,28,F
AM002324,AMS0006,1,8,2,9,45,64,B
AM002324,AMS0007,1,1,0,0,3,4,F
AM002324,AMS0008,1,2,5,9,21,37,F
AM002324,AMS0009,1,3,9,12,38,62,B
AM002324,AMS0010,1,10,8,17,24,59,C
AM002324,AMS0011,1,9,10,15,6,40,E
AM002324,AMS0012,1,6,2,2,39,49,D
AM002324,AMS0013,1,1,9,4,54,68,B
AM002324,AMS0014,1,2,6,12,21,41,E
AM002324,AMS0015,1,0,4,3,52,59,C
AM002324,AMS0016,1,9,10,19,42,80,A
AM002324,AMS0017,1,10,10,1,57,78,A
AM002324,AMS0018,1,6,3,15,21,45,D
AM002324,AMS0019,1,6,5,11,28,50,C
AM002324,AMS0020,1,10,6,5,10,31,F
AM002324,AMS0021,1,2,0,14,41,57,C
AM002324,AMS0022,1,6,5,11,33,55,C
AM002324,AMS0023,1,5,2,17,6,30,F
AM002324,AMS0024,1,8,6,5,12,31,F
AM002324,AMS0025,1,10,0,16,38,64,B
AM002324,AMS0026,1,3,5,12,34,54,C
AM002324,AMS0027,1,3,3,6,32,44,E
AM002324,AMS0028,1,2,5,15,3,25,F
AM002324,AMS0029,1,5,1,8,4,18,F
AM002324,AMS0030,1,8,9,19,23,59,C
AM002324,AMS0031,1,0,7,19,37,63,B
AM002324,AMS0032,1,3,6,11,28,48,D
AM002324,AMS0033,1,6,7,15,56,84,A
AM002324,AMS0034,1,3,4,16,7,30,F
AM002324,AMS0035,1,6,9,6,13,34,F
AM002324,AMS0036,1,1,0,3,38,42,E
AM002324,AMS0037,1,0,10,20,5,35,F
AM002324,AMS0038,1,8,6,12,34,60,B
AM002324,AMS0039,1,6,0,2,2,10,F
AM002324,AMS0040,1,6,3,13,6,28,F
AM002324,AMS0041,1,5,1,11,43,60,B
AM002324,AMS0042,1,3,2,1,49,55,C
AM002324,AMS0043,1,0,10,3,51,64,B
AM002324,AMS0044,1,1,3,2,25,31,F
AM002324,AMS0045,1,7,6,17,39,69,B
AM002324,AMS0046,1,3,10,14,11,38,F
AM002324,AMS0047,1,8,6,0,14,28,F
AM002324,AMS0048,1,7,6,15,0,28,F
AM002324,AMS0049,1,5,0,3,54,62,B
AM002324,AMS0050,1,2,9,7,39,57,C
AM002324,AMS0051,1,1,4,2,45,52,C
AM002324,AMS0052,1,6,3,11,43,63,B
AM002324,AMS0053,1,6,4,1,21,32,F
AM002324,AMS0054,1,3,9,10,20,42,E
AM002324,AMS0055,1,9,1,8,7,25,F
AM002324,AMS0056,1,2,6,20,56,84,A
AM002324,AMS0057,1,2,2,20,31,55,C
AM002324,AMS0058,1,1,3,6,24,34,F
AM002324,AMS0059,1,2,0,13,36,51,C
AM002324,AMS0060,1,0,7,13,20,40,E
AM002324,AMS0061,1,5,9,6,1,21,F
AM002324,AMS0062,1,6,2,12,12,32,F
AM002324,AMS0063,1,6,8,11,53,78,A
AM002324,AMS0064,1,3,6,10,40,59,C
AM002324,AMS0065,1,8,5,11,19,43,E
AM002324,AMS0066,1,4,7,20,3,34,F
AM002324,AMS0067,1,1,6,0,29,36,F
AM002324,AMS0068,1,5,9,7,55,76,A
AM002324,AMS0069,1,5,9,5,37,56,C
AM002324,AMS0070,1,8,1,2,56,67,B
AM002324,AMS0071,1,3,10,18,38,69,B
AM002324,AMS0072,1,2,1,19,51,73,A
AM002324,AMS0073,1,3,10,5,40,58,C
AM002324,AMS0074,1,5,0,14,42,61,B
AM002324,AMS0075,1,2,10,19,40,71,A
AM002324,AMS0076,1,9,3,12,39,63,B
AM002324,AMS0077,1,7,6,17,43,73,A
AM002324,AMS0078,1,2,6,17,30,55,C
AM002324,AMS0079,1,3,5,12,57,77,A
AM002324,AMS0080,1,9,5,16,54,84,A
AM002324,AMS0081,1,5,8,16,1,30,F
AM002324,AMS0082,1,0,0,12,46,58,C
AM002324,AMS0083,1,2,4,5,38,49,D
AM002324,AMS0084,1,3,8,12,35,58,C
AM002324,AMS0085,1,4,0,0,54,58,C
AM002324,AMS0086,1,2,9,11,12,34,F
AM002324,AMS0087,1,8,8,10,14,40,E
AM002324,AMS0088,1,0,0,5,55,60,B
AM002324,AMS0089,1,3,4,11,35,53,C
AM002324,AMS0090,1,8,3,12,16,39,F
AM002324,AMS0091,1,10,8,1,57,76,A
AM002324,AMS0092,1,5,9,5,5,24,F
AM002324,AMS0093,1,5,8,16,16,45,D
AM002324,AMS0094,1,9,9,12,7,37,F
AM002324,AMS0095,1,2,10,19,32,63,B
AM002324,AMS0096,1,4,5,13,29,51,C
AM002324,AMS0097,1,8,7,14,5,34,F
AM002324,AMS0098,1,6,4,4,17,31,F
AM002324,AMS0099,1,9,0,10,20,39,F
AM002324,AMS0100,1,1,2,19,31,53,C
AM002324,AMS0101,1,9,1,18,15,43,E
AM002324,AMS0102,1,8,0,2,55,65,B
AM002324,AMS0103,1,9,9,14,54,86,A
AM002324,AMS0001,2,9,2,9,31,51,C
AM002324,AMS0002,2,6,3,16,32,57,C
AM002324,AMS0003,2,1,7,14,51,73,A
AM002324,AMS0004,2,9,5,7,38,59,C
AM002324,AMS0005,2,6,6,19,57,88,A
AM002324,AMS0006,2,9,9,20,30,68,B
AM002324,AMS0007,2,1,4,19,4,28,F
AM002324,AMS0008,2,9,5,19,48,81,A
AM002324,AMS0009,2,0,1,15,26,42,E
AM002324,AMS0010,2,1,5,5,58,69,B
AM002324,AMS0011,2,5,2,10,60,77,A
AM002324,AMS0012,2,4,5,20,48,77,A
AM002324,AMS0013,2,8,9,0,36,53,C
AM002324,AMS0014,2,8,2,18,52,80,A
AM002324,AMS0015,2,3,4,7,6,20,F
AM002324,AMS0016,2,0,9,0,43,52,C
AM002324,AMS0017,2,9,7,2,31,49,D
AM002324,AMS0018,2,4,6,9,50,69,B
AM002324,AMS0019,2,0,9,9,52,70,A
AM002324,AMS0020,2,10,6,20,35,71,A
AM002324,AMS0021,2,2,6,6,46,60,B
AM002324,AMS0022,2,1,5,18,52,76,A
AM002324,AMS0023,2,2,10,16,30,58,C
AM002324,AMS0024,2,5,8,11,30,54,C
AM002324,AMS0025,2,6,6,10,16,38,F
AM002324,AMS0026,2,10,4,6,39,59,C
AM002324,AMS0027,2,9,10,16,59,94,A
AM002324,AMS0028,2,6,3,2,32,43,E
AM002324,AMS0029,2,8,8,10,9,35,F
AM002324,AMS0030,2,5,5,8,59,77,A
AM002324,AMS0031,2,6,8,7,14,35,F
AM002324,AMS0032,2,9,7,20,41,77,A
AM002324,AMS0033,2,1,0,5,15,21,F
AM002324,AMS0034,2,8,5,7,5,25,F
AM002324,AMS0035,2,8,10,12,9,39,F
AM002324,AMS0036,2,5,7,16,12,40,E
AM002324,AMS0037,2,3,6,12,40,61,B
AM002324,AMS0038,2,5,6,5,1,17,F
AM002324,AMS0039,2,6,7,16,50,79,A
AM002324,AMS0040,2,3,0,7,25,35,F
AM002324,AMS0041,2,3,1,18,51,73,A
AM002324,AMS0042,2,5,3,11,2,21,F
AM002324,AMS0043,2,10,2,1,14,27,F
AM002324,AMS0044,2,3,4,16,34,57,C
AM002324,AMS0045,2,4,2,9,25,40,E
AM002324,AMS0046,2,10,1,0,56,67,B
AM002324,AMS0047,2,4,10,14,7,35,F
AM002324,AMS0048,2,2,8,10,60,80,A
AM002324,AMS0049,2,5,6,19,52,82,A
AM002324,AMS0050,2,4,8,16,18,46,D
AM002324,AMS0051,2,3,0,12,52,67,B
AM002324,AMS0052,2,2,6,20,35,63,B
AM002324,AMS0053,2,3,9,4,15,31,F
AM002324,AMS0054,2,7,6,5,8,26,F
AM002324,AMS0055,2,0,9,12,49,70,A
AM002324,AMS0056,2,4,6,17,15,42,E
AM002324,AMS0057,2,0,4,13,4,21,F
AM002324,AMS0058,2,2,6,13,44,65,B
AM002324,AMS0059,2,0,6,6,31,43,E
AM002324,AMS0060,2,1,2,11,15,29,F
AM002324,AMS0061,2,9,5,14,37,65,B
AM002324,AMS0062,2,5,5,7,18,35,F
AM002324,AMS0063,2,6,0,13,10,29,F
AM002324,AMS0064,2,6,6,11,43,66,B
AM002324,AMS0065,2,4,10,16,14,44,E
AM002324,AMS0066,2,5,8,14,57,84,A
AM002324,AMS0067,2,10,10,20,26,66,B
AM002324,AMS0068,2,5,8,13,6,32,F
AM002324,AMS0069,2,9,5,2,10,26,F
AM002324,AMS0070,2,0,1,17,55,73,A
AM002324,AMS0071,2,3,6,20,34,63,B
AM002324,AMS0072,2,0,5,8,3,16,F
AM002324,AMS0073,2,9,5,18,32,64,B
AM002324,AMS0074,2,5,4,16,26,51,C
AM002324,AMS0075,2,7,10,11,2,30,F
AM002324,AMS0076,2,6,4,20,18,48,D
AM002324,AMS0077,2,7,1,1,14,23,F
AM002324,AMS0078,2,4,7,0,14,25,F
AM002324,AMS0079,2,10,6,19,48,83,A
AM002324,AMS0080,2,2,10,19,58,89,A
AM002324,AMS0081,2,8,6,2,57,73,A
AM002324,AMS0082,2,6,1,17,6,30,F
AM002324,AMS0083,2,0,7,18,5,30,F
AM002324,AMS0084,2,9,6,11,32,58,C
AM002324,AMS0085,2,4,4,13,37,58,C
AM002324,AMS0086,2,0,2,16,29,47,D
AM002324,AMS0087,2,7,9,3,3,22,F
AM002324,AMS0088,2,10,1,11,48,70,A
AM002324,AMS0089,2,0,9,13,26,48,D
AM002324,AMS0090,2,6,0,3,30,39,F
AM002324,AMS0091,2,2,0,19,3,24,F
AM002324,AMS0092,2,2,8,12,44,66,B
AM002324,AMS0093,2,9,1,12,30,52,C
AM002324,AMS0094,2,8,0,16,6,30,F
AM002324,AMS0095,2,5,2,20,26,53,C
AM002324,AMS0096,2,6,6,2,59,73,A
AM002324,AMS0097,2,7,0,0,51,58,C
AM002324,AMS0098,2,8,6,19,25,58,C
AM002324,AMS0099,2,3,9,18,47,77,A
AM002324,AMS0100,2,9,2,17,11,39,F
AM002324,AMS0101,2,4,10,8,50,72,A
AM002324,AMS0102,2,10,1,15,34,60,B
AM002324,AMS0103,2,4,8,11,1,24,F
AM002324,AMS0001,3,8,10,8,3,29,F
AM002324,AMS0002,3,7,1,11,25,44,E
AM002324,AMS0003,3,8,6,1,13,28,F
AM002324,AMS0004,3,0,9,13,38,60,B
AM002324,AMS0005,3,8,7,16,48,79,A
AM002324,AMS0006,3,6,6,5,14,31,F
AM002324,AMS0007,3,3,10,13,23,49,D
AM002324,AMS0008,3,3,10,7,49,69,B
AM002324,AMS0009,3,1,2,5,1,9,F
AM002324,AMS0010,3,1,10,5,27,43,E
AM002324,AMS0011,3,7,6,20,59,92,A
AM002324,AMS0012,3,3,1,18,56,78,A
AM002324,AMS0013,3,9,3,11,60,83,A
AM002324,AMS0014,3,9,1,18,59,87,A
AM002324,AMS0015,3,7,0,6,42,55,C
AM002324,AMS0016,3,1,10,14,20,45,D
AM002324,AMS0017,3,9,0,16,3,28,F
AM002324,AMS0018,3,7,5,8,25,45,D
AM002324,AMS0019,3,7,4,7,34,52,C
AM002324,AMS0020,3,7,10,4,46,67,B
AM002324,AMS0021,3,7,8,2,13,30,F
AM002324,AMS0022,3,4,7,11,56,78,A
AM002324,AMS0023,3,0,7,20,20,47,D
AM002324,AMS0024,3,8,10,3,29,50,C
AM002324,AMS0025,3,3,7,20,52,82,A
AM002324,AMS0026,3,0,4,10,59,73,A
AM002324,AMS0027,3,8,8,9,28,53,C
AM002324,AMS0028,3,8,8,7,5,28,F
AM002324,AMS0029,3,2,5,6,5,18,F
AM002324,AMS0030,3,9,10,4,9,32,F
AM002324,AMS0031,3,1,6,13,9,29,F
AM002324,AMS0032,3,5,5,2,10,22,F
AM002324,AMS0033,3,0,4,18,39,61,B
AM002324,AMS0034,3,1,1,16,26,44,E
AM002324,AMS0035,3,8,7,5,30,50,C
AM002324,AMS0036,3,6,6,15,45,72,A
AM002324,AMS0037,3,0,8,14,34,56,C
AM002324,AMS0038,3,6,1,1,60,68,B
AM002324,AMS0039,3,4,10,8,60,82,A
AM002324,AMS0040,3,3,7,5,9,24,F
AM002324,AMS0041,3,9,5,4,43,61,B
AM002324,AMS0042,3,6,7,20,21,54,C
AM002324,AMS0043,3,4,9,20,1,34,F
AM002324,AMS0044,3,5,9,19,55,88,A
AM002324,AMS0045,3,4,7,13,37,61,B
AM002324,AMS0046,3,7,1,20,30,58,C
AM002324,AMS0047,3,8,3,14,54,79,A
AM002324,AMS0048,3,3,1,10,11,25,F
AM002324,AMS0049,3,9,10,1,13,33,F
AM002324,AMS0050,3,9,7,1,54,71,A
AM002324,AMS0051,3,0,2,8,7,17,F
AM002324,AMS0052,3,2,7,9,17,35,F
AM002324,AMS0053,3,0,4,15,39,58,C
AM002324,AMS0054,3,7,7,10,23,47,D
AM002324,AMS0055,3,4,10,14,47,75,A
AM002324,AMS0056,3,7,10,15,13,45,D
AM002324,AMS0057,3,7,9,0,7,23,F
AM002324,AMS0058,3,1,5,0,22,28,F
AM002324,AMS0059,3,1,9,0,14,24,F
AM002324,AMS0060,3,3,5,17,0,25,F
AM002324,AMS0061,3,5,7,11,14,37,F
AM002324,AMS0062,3,5,9,9,53,76,A
AM002324,AMS0063,3,3,8,19,6,36,F
AM002324,AMS0064,3,7,2,8,24,41,E
AM002324,AMS0065,3,2,8,18,29,57,C
AM002324,AMS0066,3,8,5,18,24,55,C
AM002324,AMS0067,3,3,0,0,43,46,D
AM002324,AMS0068,3,10,7,4,25,46,D
AM002324,AMS0069,3,5,10,7,54,76,A
AM002324,AMS0070,3,7,1,2,27,37,F
AM002324,AMS0071,3,2,3,15,0,20,F
AM002324,AMS0072,3,1,5,17,34,57,C
AM002324,AMS0073,3,10,8,10,1,29,F
AM002324,AMS0074,3,1,5,11,5,22,F
AM002324,AMS0075,3,3,3,6,23,35,F
AM002324,AMS0076,3,10,1,17,8,36,F
AM002324,AMS0077,3,9,6,1,17,33,F
AM002324,AMS0078,3,10,5,15,44,74,A
AM002324,AMS0079,3,9,7,15,47,78,A
AM002324,AMS0080,3,6,1,1,15,23,F
AM002324,AMS0081,3,7,7,6,58,78,A
AM002324,AMS0082,3,8,4,4,59,75,A
AM002324,AMS0083,3,5,0,8,21,34,F
AM002324,AMS0084,3,1,7,13,53,74,A
AM002324,AMS0085,3,4,3,3,12,22,F
AM002324,AMS0086,3,6,9,14,30,59,C
AM002324,AMS0087,3,8,5,20,46,79,A
AM002324,AMS0088,3,6,9,3,60,78,A
AM002324,AMS0089,3,7,3,13,6,29,F
AM002324,AMS0090,3,4,3,9,13,29,F
AM002324,AMS0091,3,5,2,4,54,65,B
AM002324,AMS0092,3,1,8,9,28,46,D
AM002324,AMS0093,3,3,2,7,41,53,C
AM002324,AMS0094,3,1,2,13,60,76,A
AM002324,AMS0095,3,4,5,3,48,60,B
AM002324,AMS0096,3,1,3,18,21,43,E
AM002324,AMS0097,3,10,2,5,25,42,E
AM002324,AMS0098,3,8,6,6,39,59,C
AM002324,AMS0099,3,5,4,9,53,71,A
AM002324,AMS0100,3,2,10,20,52,84,A
AM002324,AMS0101,3,10,4,10,29,53,C
AM002324,AMS0102,3,5,10,20,11,46,D
AM002324,AMS0103,3,2,1,18,1,22,F
AM002324,AMS0001,4,0,5,13,25,43,E
AM002324,AMS0002,4,5,3,10,26,44,E
AM002324,AMS0003,4,10,6,13,36,65,B
AM002324,AMS0004,4,0,6,14,12,32,F
AM002324,AMS0005,4,8,3,2,30,43,E
AM002324,AMS0006,4,5,0,16,19,40,E
AM002324,AMS0007,4,9,9,11,28,57,C
AM002324,AMS0008,4,9,0,12,20,41,E
AM002324,AMS0009,4,9,8,11,1,29,F
AM002324,AMS0010,4,9,8,1,29,47,D
AM002324,AMS0011,4,6,7,0,32,45,D
AM002324,AMS0012,4,9,6,20,33,68,B
AM002324,AMS0013,4,3,7,10,22,42,E
AM002324,AMS0014,4,7,9,2,46,64,B
AM002324,AMS0015,4,7,9,20,54,90,A
AM002324,AMS0016,4,0,3,20,1,24,F
AM002324,AMS0017,4,9,8,19,7,43,E
AM002324,AMS0018,4,1,0,6,37,44,E
AM002324,AMS0019,4,3,0,17,4,24,F
AM002324,AMS0020,4,3,5,12,6,26,F
AM002324,AMS0021,4,1,0,13,17,31,F
AM002324,AMS0022,4,2,2,19,21,44,E
AM002324,AMS0023,4,10,6,17,13,46,D
AM002324,AMS0024,4,6,1,19,0,26,F
AM002324,AMS0025,4,0,3,18,39,60,B
AM002324,AMS0026,4,8,10,0,50,68,B
AM002324,AMS0027,4,4,6,8,54,72,A
AM002324,AMS0028,4,6,10,0,0,16,F
AM002324,AMS0029,4,10,10,4,39,63,B
AM002324,AMS0030,4,8,2,20,47,77,A
AM002324,AMS0031,4,4,1,6,16,27,F
AM002324,AMS0032,4,1,3,7,59,70,A
AM002324,AMS0033,4,2,5,0,27,34,F
AM002324,AMS0034,4,7,2,19,57,85,A
AM002324,AMS0035,4,3,9,6,52,70,A
AM002324,AMS0036,4,0,3,2,31,36,F
AM002324,AMS0037,4,0,0,20,53,73,A
AM002324,AMS0038,4,9,6,7,5,27,F
AM002324,AMS0039,4,0,7,14,21,42,E
AM002324,AMS0040,4,0,5,3,48,56,C
AM002324,AMS0041,4,3,0,0,28,31,F
AM002324,AMS0042,4,3,5,7,58,73,A
AM002324,AMS0043,4,6,3,19,56,84,A
AM002324,AMS0044,4,2,7,9,24,42,E
AM002324,AMS0045,4,4,6,5,10,25,F
AM002324,AMS0046,4,8,6,19,31,64,B
AM002324,AMS0047,4,6,5,4,17,32,F
AM002324,AMS0048,4,1,6,6,22,35,F
AM002324,AMS0049,4,1,3,11,43,58,C
AM002324,AMS0050,4,3,2,7,6,18,F
AM002324,AMS0051,4,1,2,6,12,21,F
AM002324,AMS0052,4,7,8,5,32,52,C
AM002324,AMS0053,4,7,7,9,26,49,D
AM002324,AMS0054,4,0,1,5,59,65,B
AM002324,AMS0055,4,6,9,9,29,53,C
AM002324,AMS0056,4,9,6,12,31,58,C
AM002324,AMS0057,4,4,3,3,42,52,C
AM002324,AMS0058,4,10,9,17,25,61,B
AM002324,AMS0059,4,1,0,17,9,27,F
AM002324,AMS0060,4,10,7,13,57,87,A
AM002324,AMS0061,4,1,0,16,22,39,F
AM002324,AMS0062,4,10,6,18,1,35,F
AM002324,AMS0063,4,3,4,18,21,46,D
AM002324,AMS0064,4,0,6,4,8,18,F
AM002324,AMS0065,4,6,6,4,23,39,F
AM002324,AMS0066,4,4,9,9,54,76,A
AM002324,AMS0067,4,4,0,19,29,52,C
AM002324,AMS0068,4,0,4,8,19,31,F
AM002324,AMS0069,4,10,6,18,32,66,B
AM002324,AMS0070,4,5,7,7,21,40,E
AM002324,AMS0071,4,2,0,13,4,19,F
AM002324,AMS0072,4,10,5,18,10,43,E
AM002324,AMS0073,4,0,5,19,2,26,F
AM002324,AMS0074,4,4,5,16,29,54,C
AM002324,AMS0075,4,9,10,19,6,44,E
AM002324,AMS0076,4,2,4,0,33,39,F
AM002324,AMS0077,4,6,5,1,39,51,C
AM002324,AMS0078,4,4,7,3,27,41,E
AM002324,AMS0079,4,2,4,12,9,27,F
AM002324,AMS0080,4,4,9,4,44,61,B
AM002324,AMS0081,4,3,6,16,9,34,F
AM002324,AMS0082,4,9,1,12,23,45,D
AM002324,AMS0083,4,4,7,20,46,77,A
AM002324,AMS0084,4,10,4,5,59,78,A
AM002324,AMS0085,4,6,3,9,48,66,B
AM002324,AMS0086,4,7,5,9,45,66,B
AM002324,AMS0087,4,10,10,3,27,50,C
AM002324,AMS0088,4,10,0,2,9,21,F
AM002324,AMS0089,4,4,10,16,57,87,A
AM002324,AMS0090,4,6,4,18,33,61,B
AM002324,AMS0091,4,6,10,5,56,77,A
AM002324,AMS0092,4,8,4,20,28,60,B
AM002324,AMS0093,4,1,10,6,54,71,A
AM002324,AMS0094,4,8,9,10,7,34,F
AM002324,AMS0095,4,8,7,15,13,43,E
AM002324,AMS0096,4,2,7,19,54,82,A
AM002324,AMS0097,4,8,6,3,47,64,B
AM002324,AMS0098,4,9,1,18,38,66,B
AM002324,AMS0099,4,3,9,5,6,23,F
AM002324,AMS0100,4,5,7,20,8,40,E
AM002324,AMS0101,4,6,6,2,36,50,C
AM002324,AMS0102,4,8,6,5,44,63,B
AM002324,AMS0103,4,7,1,9,54,71,A
AM002324,AMS0001,5,5,3,12,0,20,F
AM002324,AMS0002,5,1,6,1,39,47,D
AM002324,AMS0003,5,9,5,4,45,63,B
AM002324,AMS0004,5,0,5,11,42,58,C
AM002324,AMS0005,5,9,10,20,39,78,A
AM002324,AMS0006,5,9,9,12,47,77,A
AM002324,AMS0007,5,7,9,14,47,77,A
AM002324,AMS0008,5,8,0,10,0,18,F
AM002324,AMS0009,5,0,10,14,0,24,F
AM002324,AMS0010,5,5,5,7,47,64,B
AM002324,AMS0011,5,6,9,1,46,62,B
AM002324,AMS0012,5,6,2,14,32,54,C
AM002324,AMS0013,5,3,6,6,40,55,C
AM002324,AMS0014,5,5,1,13,9,28,F
AM002324,AMS0015,5,9,9,3,35,56,C
AM002324,AMS0016,5,0,1,19,4,24,F
AM002324,AMS0017,5,10,8,8,40,66,B
AM002324,AMS0018,5,9,10,13,15,47,D
AM002324,AMS0019,5,10,7,7,29,53,C
AM002324,AMS0020,5,9,5,5,60,79,A
AM002324,AMS0021,5,6,1,4,28,39,F
AM002324,AMS0022,5,1,0,15,19,35,F
AM002324,AMS0023,5,9,9,9,15,42,E
AM002324,AMS0024,5,2,2,9,33,46,D
AM002324,AMS0025,5,3,9,10,28,50,C
AM002324,AMS0026,5,8,2,19,14,43,E
AM002324,AMS0027,5,8,7,3,18,36,F
AM002324,AMS0028,5,0,2,18,54,74,A
AM002324,AMS0029,5,3,6,20,31,60,B
AM002324,AMS0030,5,4,4,15,60,83,A
AM002324,AMS0031,5,5,0,1,26,32,F
AM002324,AMS0032,5,4,10,15,29,58,C
AM002324,AMS0033,5,8,5,6,57,76,A
AM002324,AMS0034,5,8,3,20,50,81,A
AM002324,AMS0035,5,10,8,2,45,65,B
AM002324,AMS0036,5,9,9,13,15,46,D
AM002324,AMS0037,5,0,2,14,29,45,D
AM002324,AMS0038,5,8,2,19,34,63,B
AM002324,AMS0039,5,4,10,6,44,64,B
AM002324,AMS0040,5,4,3,5,25,37,F
AM002324,AMS0041,5,10,5,5,26,46,D
AM002324,AMS0042,5,2,3,9,27,41,E
AM002324,AMS0043,5,2,9,20,20,51,C
AM002324,AMS0044,5,0,4,8,59,71,A
AM002324,AMS0045,5,0,10,16,49,75,A
AM002324,AMS0046,5,6,0,6,32,44,E
AM002324,AMS0047,5,1,3,13,45,62,B
AM002324,AMS0048,5,9,6,3,50,68,B
AM002324,AMS0049,5,5,5,18,18,46,D
AM002324,AMS0050,5,4,2,13,60,79,A
AM002324,AMS0051,5,2,9,4,30,45,D
AM002324,AMS0052,5,2,6,10,28,46,D
AM002324,AMS0053,5,5,6,0,47,58,C
AM002324,AMS0054,5,1,8,3,25,37,F
AM002324,AMS0055,5,4,8,9,39,60,B
AM002324,AMS0056,5,5,1,20,60,86,A
AM002324,AMS0057,5,9,3,2,49,63,B
AM002324,AMS0058,5,6,9,8,1,24,F
AM002324,AMS0059,5,6,7,3,40,56,C
AM002324,AMS0060,5,6,7,14,9,36,F
AM002324,AMS0061,5,6,5,8,56,75,A
AM002324,AMS0062,5,2,8,9,2,21,F
AM002324,AMS0063,5,7,3,18,14,42,E
AM002324,AMS0064,5,10,2,8,47,67,B
AM002324,AMS0065,5,10,8,7,44,69,B
AM002324,AMS0066,5,9,5,11,54,79,A
AM002324,AMS0067,5,1,4,13,42,60,B
AM002324,AMS0068,5,9,3,2,41,55,C
AM002324,AMS0069,5,8,2,15,8,33,F
AM002324,AMS0070,5,2,1,2,14,19,F
AM002324,AMS0071,5,7,9,14,28,58,C
AM002324,AMS0072,5,9,2,10,16,37,F
AM002324,AMS0073,5,4,7,1,37,49,D
AM002324,AMS0074,5,1,5,20,41,67,B
AM002324,AMS0075,5,4,5,9,12,30,F
AM002324,AMS0076,5,3,0,16,21,40,E
AM002324,AMS0077,5,0,4,12,27,43,E
AM002324,AMS0078,5,9,2,8,6,25,F
AM002324,AMS0079,5,3,7,12,1,23,F
AM002324,AMS0080,5,4,9,2,24,39,F
AM002324,AMS0081,5,8,5,3,25,41,E
AM002324,AMS0082,5,0,2,10,39,51,C
AM002324,AMS0083,5,9,9,10,41,69,B
AM002324,AMS0084,5,10,2,1,13,26,F
AM002324,AMS0085,5,9,2,11,60,82,A
AM002324,AMS0086,5,7,4,5,28,44,E
AM002324,AMS0087,5,4,5,15,7,31,F
AM002324,AMS0088,5,0,10,4,4,18,F
AM002324,AMS0089,5,10,7,2,22,41,E
AM002324,AMS0090,5,5,6,15,24,50,C
AM002324,AMS0091,5,6,10,11,13,40,E
AM002324,AMS0092,5,4,4,0,11,19,F
AM002324,AMS0093,5,2,9,6,43,60,B
AM002324,AMS0094,5,10,5,13,56,84,A
AM002324,AMS0095,5,3,9,1,41,54,C
AM002324,AMS0096,5,4,6,9,13,32,F
AM002324,AMS0097,5,3,10,8,59,80,A
AM002324,AMS0098,5,4,3,8,57,72,A
AM002324,AMS0099,5,6,10,11,57,84,A
AM002324,AMS0100,5,5,9,3,4,21,F
AM002324,AMS0101,5,6,5,2,53,66,B
AM002324,AMS0102,5,0,5,11,36,52,C
AM002324,AMS0103,5,7,5,17,14,43,E
AM002324,AMS0001,6,5,1,5,44,55,C
AM002324,AMS0002,6,1,8,20,21,50,C
AM002324,AMS0003,6,7,1,20,32,60,B
AM002324,AMS0004,6,0,7,5,19,31,F
AM002324,AMS0005,6,3,1,20,54,78,A
AM002324,AMS0006,6,7,5,1,1,14,F
AM002324,AMS0007,6,1,7,10,53,71,A
AM002324,AMS0008,6,2,8,5,2,17,F
AM002324,AMS0009,6,3,6,1,3,13,F
AM002324,AMS0010,6,9,3,5,44,61,B
AM002324,AMS0011,6,4,4,20,43,71,A
AM002324,AMS0012,6,7,8,16,45,76,A
AM002324,AMS0013,6,8,5,18,25,56,C
AM002324,AMS0014,6,0,2,14,3,19,F
AM002324,AMS0015,6,2,7,16,25,50,C
AM002324,AMS0016,6,0,0,18,10,28,F
AM002324,AMS0017,6,4,8,19,40,71,A
AM002324,AMS0018,6,10,5,12,12,39,F
AM002324,AMS0019,6,7,1,15,12,35,F
AM002324,AMS0020,6,0,10,3,18,31,F
AM002324,AMS0021,6,8,1,14,1,24,F
AM002324,AMS0022,6,5,9,2,59,75,A
AM002324,AMS0023,6,2,1,14,18,35,F
AM002324,AMS0024,6,7,0,3,26,36,F
AM002324,AMS0025,6,5,5,4,58,72,A
AM002324,AMS0026,6,9,8,3,52,72,A
AM002324,AMS0027,6,8,9,14,39,70,A
AM002324,AMS0028,6,2,10,20,50,82,A
AM002324,AMS0029,6,4,10,13,8,35,F
AM002324,AMS0030,6,10,1,17,56,84,A
AM002324,AMS0031,6,7,8,4,58,77,A
AM002324,AMS0032,6,0,2,17,22,41,E
AM002324,AMS0033,6,10,0,17,57,84,A
AM002324,AMS0034,6,0,1,10,2,13,F
AM002324,AMS0035,6,1,6,20,57,84,A
AM002324,AMS0036,6,1,3,17,25,46,D
AM002324,AMS0037,6,10,6,14,46,76,A
AM002324,AMS0038,6,2,6,4,28,40,E
AM002324,AMS0039,6,4,6,18,26,54,C
AM002324,AMS0040,6,10,5,16,37,68,B
AM002324,AMS0041,6,9,2,16,37,64,B
AM002324,AMS0042,6,2,6,8,44,60,B
AM002324,AMS0043,6,4,7,11,27,49,D
AM002324,AMS0044,6,3,5,20,20,48,D
AM002324,AMS0045,6,9,0,6,15,30,F
AM002324,AMS0046,6,6,5,19,38,68,B
AM002324,AMS0047,6,7,4,14,17,42,E
AM002324,AMS0048,6,10,6,10,14,40,E
AM002324,AMS0049,6,1,5,15,24,45,D
AM002324,AMS0050,6,10,6,20,37,73,A
AM002324,AMS0051,6,2,9,5,13,29,F
AM002324,AMS0052,6,2,8,11,34,55,C
AM002324,AMS0053,6,4,6,5,25,40,E
AM002324,AMS0054,6,5,10,11,60,86,A
AM002324,AMS0055,6,10,9,5,5,29,F
AM002324,AMS0056,6,1,4,19,45,69,B
AM002324,AMS0057,6,1,9,7,30,47,D
AM002324,AMS0058,6,3,5,17,10,35,F
AM002324,AMS0059,6,9,7,13,15,44,E
AM002324,AMS0060,6,7,6,14,49,76,A
AM002324,AMS0061,6,0,8,17,4,29,F
AM002324,AMS0062,6,3,8,8,44,63,B
AM002324,AMS0063,6,3,2,1,7,13,F
AM002324,AMS0064,6,8,2,19,22,51,C
AM002324,AMS0065,6,3,10,6,45,64,B
AM002324,AMS0066,6,7,10,10,31,58,C
AM002324,AMS0067,6,9,4,4,46,63,B
AM002324,AMS0068,6,5,6,4,7,22,F
AM002324,AMS0069,6,10,5,15,11,41,E
AM002324,AMS0070,6,4,8,13,14,39,F
AM002324,AMS0071,6,1,1,11,23,36,F
AM002324,AMS0072,6,2,6,20,17,45,D
AM002324,AMS0073,6,2,8,15,33,58,C
AM002324,AMS0074,6,9,4,12,19,44,E
AM002324,AMS0075,6,7,7,6,47,67,B
AM002324,AMS0076,6,4,10,1,0,15,F
AM002324,AMS0077,6,0,10,6,39,55,C
AM002324,AMS0078,6,3,3,8,54,68,B
AM002324,AMS0079,6,7,3,19,50,79,A
AM002324,AMS0080,6,7,1,16,0,24,F
AM002324,AMS0081,6,7,5,4,56,72,A
AM002324,AMS0082,6,1,4,12,45,62,B
AM002324,AMS0083,6,1,7,11,33,52,C
AM002324,AMS0084,6,9,2,12,58,81,A
AM002324,AMS0085,6,7,3,0,2,12,F
AM002324,AMS0086,6,2,5,18,49,74,A
AM002324,AMS0087,6,2,7,17,25,51,C
AM002324,AMS0088,6,5,7,5,7,24,F
AM002324,AMS0089,6,1,6,2,40,49,D
AM002324,AMS0090,6,0,9,5,57,71,A
AM002324,AMS0091,6,8,8,2,25,43,E
AM002324,AMS0092,6,6,1,16,44,67,B
AM002324,AMS0093,6,8,2,15,37,62,B
AM002324,AMS0094,6,10,3,1,19,33,F
AM002324,AMS0095,6,8,8,12,28,56,C
AM002324,AMS0096,6,8,2,0,2,12,F
AM002324,AMS0097,6,8,1,19,58,86,A
AM002324,AMS0098,6,2,4,5,4,15,F
AM002324,AMS0099,6,3,7,10,34,54,C
AM002324,AMS0100,6,0,6,17,32,55,C
AM002324,AMS0101,6,7,4,10,53,74,A
AM002324,AMS0102,6,2,10,5,16,33,F
AM002324,AMS0103,6,5,5,19,11,40,E
AM002324,AMS0001,7,6,2,4,32,44,E
AM002324,AMS0002,7,2,2,4,25,33,F
AM002324,AMS0003,7,3,3,0,6,12,F
AM002324,AMS0004,7,8,6,16,30,60,B
AM002324,AMS0005,7,3,4,9,41,57,C
AM002324,AMS0006,7,9,2,20,1,32,F
AM002324,AMS0007,7,7,7,9,57,80,A
AM002324,AMS0008,7,2,8,3,43,56,C
AM002324,AMS0009,7,0,9,14,45,68,B
AM002324,AMS0010,7,3,2,7,32,44,E
AM002324,AMS0011,7,7,10,10,30,57,C
AM002324,AMS0012,7,5,1,20,59,85,A
AM002324,AMS0013,7,5,4,13,10,32,F
AM002324,AMS0014,7,7,6,6,60,79,A
AM002324,AMS0015,7,10,7,10,25,52,C
AM002324,AMS0016,7,9,5,17,9,40,E
AM002324,AMS0017,7,5,3,18,7,33,F
AM002324,AMS0018,7,6,7,18,20,51,C
AM002324,AMS0019,7,5,3,4,32,44,E
AM002324,AMS0020,7,7,0,7,4,18,F
AM002324,AMS0021,7,7,3,20,7,37,F
AM002324,AMS0022,7,4,1,6,15,26,F
AM002324,AMS0023,7,7,8,12,46,73,A
AM002324,AMS0024,7,8,1,4,40,53,C
AM002324,AMS0025,7,10,7,19,55,91,A
AM002324,AMS0026,7,10,4,10,47,71,A
AM002324,AMS0027,7,8,8,11,0,27,F
AM002324,AMS0028,7,6,10,7,19,42,E
AM002324,AMS0029,7,0,1,16,0,17,F
AM002324,AMS0030,7,9,9,6,41,65,B
AM002324,AMS0031,7,9,6,12,39,66,B
AM002324,AMS0032,7,3,3,12,59,77,A
AM002324,AMS0033,7,1,7,16,16,40,E
AM002324,AMS0034,7,3,2,8,10,23,F
AM002324,AMS0035,7,8,1,6,51,66,B
AM002324,AMS0036,7,1,1,6,50,58,C
AM002324,AMS0037,7,5,5,1,29,40,E
AM002324,AMS0038,7,7,4,7,37,55,C
AM002324,AMS0039,7,8,6,6,31,51,C
AM002324,AMS0040,7,10,2,12,41,65,B
AM002324,AMS0041,7,10,2,14,20,46,D
AM002324,AMS0042,7,7,1,5,9,22,F
AM002324,AMS0043,7,2,5,0,17,24,F
AM002324,AMS0044,7,5,4,11,59,79,A
AM002324,AMS0045,7,8,10,19,35,72,A
AM002324,AMS0046,7,0,0,17,55,72,A
AM002324,AMS0047,7,7,10,7,45,69,B
AM002324,AMS0048,7,0,10,1,37,48,D
AM002324,AMS0049,7,9,5,1,40,55,C
AM002324,AMS0050,7,9,8,4,41,62,B
AM002324,AMS0051,7,7,6,5,2,20,F
AM002324,AMS0052,7,5,9,14,46,74,A
AM002324,AMS0053,7,10,5,5,59,79,A
AM002324,AMS0054,7,0,4,14,53,71,A
AM002324,AMS0055,7,2,0,8,0,10,F
AM002324,AMS0056,7,6,9,12,13,40,E
AM002324,AMS0057,7,6,1,0,20,27,F
AM002324,AMS0058,7,10,8,15,30,63,B
AM002324,AMS0059,7,7,0,0,38,45,D
AM002324,AMS0060,7,3,2,18,1,24,F
AM002324,AMS0061,7,5,1,17,56,79,A
AM002324,AMS0062,7,3,9,18,15,45,D
AM002324,AMS0063,7,6,0,8,49,63,B
AM002324,AMS0064,7,1,9,12,16,38,F
AM002324,AMS0065,7,3,7,12,21,43,E
AM002324,AMS0066,7,3,0,14,44,61,B
AM002324,AMS0067,7,2,10,17,0,29,F
AM002324,AMS0068,7,7,5,20,31,63,B
AM002324,AMS0069,7,10,5,7,14,36,F
AM002324,AMS0070,7,2,1,11,35,49,D
AM002324,AMS0071,7,8,9,11,18,46,D
AM002324,AMS0072,7,3,6,16,5,30,F
AM002324,AMS0073,7,9,10,20,24,63,B
AM002324,AMS0074,7,5,7,12,4,28,F
AM002324,AMS0075,7,10,2,19,12,43,E
AM002324,AMS0076,7,6,3,5,53,67,B
AM002324,AMS0077,7,3,2,16,50,71,A
AM002324,AMS0078,7,3,4,20,24,51,C
AM002324,AMS0079,7,6,9,1,19,35,F
AM002324,AMS0080,7,8,9,10,3,30,F
AM002324,AMS0081,7,7,0,18,37,62,B
AM002324,AMS0082,7,5,6,19,3,33,F
AM002324,AMS0083,7,6,4,12,22,44,E
AM002324,AMS0084,7,0,8,18,21,47,D
AM002324,AMS0085,7,2,7,5,7,21,F
AM002324,AMS0086,7,2,7,16,51,76,A
AM002324,AMS0087,7,7,3,16,48,74,A
AM002324,AMS0088,7,2,9,11,16,38,F
AM002324,AMS0089,7,2,9,20,31,62,B
AM002324,AMS0090,7,1,3,6,32,42,E
AM002324,AMS0091,7,0,8,20,9,37,F
AM002324,AMS0092,7,10,10,7,58,85,A
AM002324,AMS0093,7,10,9,0,57,76,A
AM002324,AMS0094,7,3,8,8,17,36,F
AM002324,AMS0095,7,6,7,16,15,44,E
AM002324,AMS0096,7,0,10,8,10,28,F
AM002324,AMS0097,7,6,5,14,60,85,A
AM002324,AMS0098,7,1,8,14,34,57,C
AM002324,AMS0099,7,5,9,3,7,24,F
AM002324,AMS0100,7,3,6,5,15,29,F
AM002324,AMS0101,7,4,6,18,37,65,B
AM002324,AMS0102,7,4,6,13,3,26,F
AM002324,AMS0103,7,10,5,4,18,37,F
AM002324,AMS0001,8,2,0,0,53,55,C
AM002324,AMS0002,8,3,8,12,11,34,F
AM002324,AMS0003,8,5,9,9,39,62,B
AM002324,AMS0004,8,7,0,0,23,30,F
AM002324,AMS0005,8,6,2,0,33,41,E
AM002324,AMS0006,8,0,5,7,10,22,F
AM002324,AMS0007,8,3,7,17,20,47,D
AM002324,AMS0008,8,2,5,17,17,41,E
AM002324,AMS0009,8,5,8,4,44,61,B
AM002324,AMS0010,8,5,4,4,5,18,F
AM002324,AMS0011,8,6,10,4,3,23,F
AM002324,AMS0012,8,2,10,4,20,36,F
AM002324,AMS0013,8,8,6,9,35,58,C
AM002324,AMS0014,8,3,0,7,44,54,C
AM002324,AMS0015,8,0,3,11,59,73,A
AM002324,AMS0016,8,5,7,2,41,55,C
AM002324,AMS0017,8,9,2,5,59,75,A
AM002324,AMS0018,8,5,2,13,19,39,F
AM002324,AMS0019,8,9,10,16,56,91,A
AM002324,AMS0020,8,3,10,12,39,64,B
AM002324,AMS0021,8,2,9,16,55,82,A
AM002324,AMS0022,8,6,6,6,23,41,E
AM002324,AMS0023,8,6,8,14,27,55,C
AM002324,AMS0024,8,2,1,15,6,24,F
AM002324,AMS0025,8,4,2,2,46,54,C
AM002324,AMS0026,8,7,6,13,43,69,B
AM002324,AMS0027,8,2,1,20,22,45,D
AM002324,AMS0028,8,5,1,18,54,78,A
AM002324,AMS0029,8,6,1,16,12,35,F
AM002324,AMS0030,8,1,5,5,53,64,B
AM002324,AMS0031,8,1,1,2,53,57,C
AM002324,AMS0032,8,6,7,7,24,44,E
AM002324,AMS0033,8,7,2,5,53,67,B
AM002324,AMS0034,8,1,5,5,14,25,F
AM002324,AMS0035,8,3,8,6,44,61,B
AM002324,AMS0036,8,9,4,4,0,17,F
AM002324,AMS0037,8,7,0,12,42,61,B
AM002324,AMS0038,8,8,9,2,54,73,A
AM002324,AMS0039,8,3,8,12,20,43,E
AM002324,AMS0040,8,2,8,9,48,67,B
AM002324,AMS0041,8,7,6,3,14,30,F
AM002324,AMS0042,8,1,10,15,36,62,B
AM002324,AMS0043,8,6,3,8,29,46,D
AM002324,AMS0044,8,1,6,3,3,13,F
AM002324,AMS0045,8,9,7,12,22,50,C
AM002324,AMS0046,8,3,8,5,4,20,F
AM002324,AMS0047,8,1,6,19,41,67,B
AM002324,AMS0048,8,7,4,14,60,85,A
AM002324,AMS0049,8,8,5,20,13,46,D
AM002324,AMS0050,8,5,0,16,14,35,F
AM002324,AMS0051,8,0,0,10,50,60,B
AM002324,AMS0052,8,9,5,14,28,56,C
AM002324,AMS0053,8,5,0,12,11,28,F
AM002324,AMS0054,8,7,10,9,54,80,A
AM002324,AMS0055,8,7,8,0,58,73,A
AM002324,AMS0056,8,4,8,18,48,78,A
AM002324,AMS0057,8,3,0,18,7,28,F
AM002324,AMS0058,8,8,2,2,4,16,F
AM002324,AMS0059,8,5,3,2,8,18,F
AM002324,AMS0060,8,3,5,15,46,69,B
AM002324,AMS0061,8,7,4,18,19,48,D
AM002324,AMS0062,8,1,5,18,22,46,D
AM002324,AMS0063,8,0,4,16,55,75,A
AM002324,AMS0064,8,9,9,8,56,82,A
AM002324,AMS0065,8,1,10,2,17,30,F
AM002324,AMS0066,8,3,1,0,22,26,F
AM002324,AMS0067,8,0,7,5,43,55,C
AM002324,AMS0068,8,6,9,4,47,66,B
AM002324,AMS0069,8,8,10,0,42,60,B
AM002324,AMS0070,8,3,5,1,3,12,F
AM002324,AMS0071,8,8,0,10,51,69,B
AM002324,AMS0072,8,3,10,14,16,43,E
AM002324,AMS0073,8,8,5,7,36,56,C
AM002324,AMS0074,8,7,0,16,8,31,F
AM002324,AMS0075,8,0,3,17,11,31,F
AM002324,AMS0076,8,1,3,5,18,27,F
AM002324,AMS0077,8,1,7,17,20,45,D
AM002324,AMS0078,8,4,7,3,5,19,F
AM002324,AMS0079,8,4,1,15,29,49,D
AM002324,AMS0080,8,4,5,0,48,57,C
AM002324,AMS0081,8,10,9,6,16,41,E
AM002324,AMS0082,8,0,6,8,0,14,F
AM002324,AMS0083,8,10,1,10,33,54,C
AM002324,AMS0084,8,4,10,0,38,52,C
AM002324,AMS0085,8,5,0,14,33,52,C
AM002324,AMS0086,8,0,3,9,7,19,F
AM002324,AMS0087,8,1,9,12,35,57,C
AM002324,AMS0088,8,6,7,8,41,62,B
AM002324,AMS0089,8,2,5,11,40,58,C
AM002324,AMS0090,8,6,5,7,53,71,A
AM002324,AMS0091,8,5,10,7,60,82,A
AM002324,AMS0092,8,6,0,6,4,16,F
AM002324,AMS0093,8,2,2,11,40,55,C
AM002324,AMS0094,8,3,3,18,18,42,E
AM002324,AMS0095,8,9,5,0,53,67,B
AM002324,AMS0096,8,1,7,12,15,35,F
AM002324,AMS0097,8,5,3,7,34,49,D
AM002324,AMS0098,8,3,1,10,37,51,C
AM002324,AMS0099,8,0,9,7,12,28,F
AM002324,AMS0100,8,7,5,6,41,59,C
AM002324,AMS0101,8,5,2,1,18,26,F
AM002324,AMS0102,8,9,4,13,58,84,A
AM002324,AMS0103,8,5,2,13,3,23,F
AM002324,AMS0001,9,9,10,13,5,37,F
AM002324,AMS0002,9,6,1,16,33,56,C
AM002324,AMS0003,9,1,2,3,40,46,D
AM002324,AMS0004,9,1,1,16,1,19,F
AM002324,AMS0005,9,5,5,8,39,57,C
AM002324,AMS0006,9,10,7,17,14,48,D
AM002324,AMS0007,9,10,0,4,10,24,F
AM002324,AMS0008,9,7,6,18,1,32,F
AM002324,AMS0009,9,0,10,7,57,74,A
AM002324,AMS0010,9,9,0,9,48,66,B
AM002324,AMS0011,9,7,7,0,38,52,C
AM002324,AMS0012,9,6,3,10,44,63,B
AM002324,AMS0013,9,6,9,16,29,60,B
AM002324,AMS0014,9,1,2,12,33,48,D
AM002324,AMS0015,9,0,3,18,29,50,C
AM002324,AMS0016,9,9,3,14,29,55,C
AM002324,AMS0017,9,7,2,16,33,58,C
AM002324,AMS0018,9,2,9,11,15,37,F
AM002324,AMS0019,9,8,1,20,52,81,A
AM002324,AMS0020,9,9,4,7,42,62,B
AM002324,AMS0021,9,2,3,8,16,29,F
AM002324,AMS0022,9,7,8,0,40,55,C
AM002324,AMS0023,9,6,1,4,18,29,F
AM002324,AMS0024,9,1,9,16,57,83,A
AM002324,AMS0025,9,0,4,16,28,48,D
AM002324,AMS0026,9,8,8,8,17,41,E
AM002324,AMS0027,9,7,4,19,30,60,B
AM002324,AMS0028,9,1,0,16,57,74,A
AM002324,AMS0029,9,10,8,20,24,62,B
AM002324,AMS0030,9,6,5,20,40,71,A
AM002324,AMS0031,9,1,1,0,41,43,E
AM002324,AMS0032,9,2,8,0,49,59,C
AM002324,AMS0033,9,4,9,4,41,58,C
AM002324,AMS0034,9,1,4,4,53,62,B
AM002324,AMS0035,9,3,4,5,30,42,E
AM002324,AMS0036,9,10,5,17,12,44,E
AM002324,AMS0037,9,3,2,7,59,71,A
AM002324,AMS0038,9,1,7,19,38,65,B
AM002324,AMS0039,9,3,2,8,29,42,E
AM002324,AMS0040,9,8,2,2,29,41,E
AM002324,AMS0041,9,1,2,3,30,36,F
AM002324,AMS0042,9,1,6,9,50,66,B
AM002324,AMS0043,9,10,1,16,27,54,C
AM002324,AMS0044,9,1,7,18,57,83,A
AM002324,AMS0045,9,2,5,5,8,20,F
AM002324,AMS0046,9,3,8,18,43,72,A
AM002324,AMS0047,9,1,6,0,57,64,B
AM002324,AMS0048,9,9,3,1,15,28,F
AM002324,AMS0049,9,0,2,13,13,28,F
AM002324,AMS0050,9,4,8,13,49,74,A
AM002324,AMS0051,9,9,6,0,52,67,B
AM002324,AMS0052,9,8,2,8,6,24,F
AM002324,AMS0053,9,5,3,3,18,29,F
AM002324,AMS0054,9,3,7,18,9,37,F
AM002324,AMS0055,9,3,8,10,5,26,F
AM002324,AMS0056,9,9,9,8,34,60,B
AM002324,AMS0057,9,2,4,17,9,32,F
AM002324,AMS0058,9,7,6,6,51,70,A
AM002324,AMS0059,9,1,3,17,48,69,B
AM002324,AMS0060,9,2,0,0,44,46,D
AM002324,AMS0061,9,3,8,10,11,32,F
AM002324,AMS0062,9,0,0,7,18,25,F
AM002324,AMS0063,9,10,1,2,23,36,F
AM002324,AMS0064,9,0,4,9,14,27,F
AM002324,AMS0065,9,6,0,19,44,69,B
AM002324,AMS0066,9,7,7,18,13,45,D
AM002324,AMS0067,9,1,2,8,30,41,E
AM002324,AMS0068,9,6,5,5,45,61,B
AM002324,AMS0069,9,3,5,20,0,28,F
AM002324,AMS0070,9,6,6,6,39,57,C
AM002324,AMS0071,9,6,7,15,40,68,B
AM002324,AMS0072,9,9,3,11,15,38,F
AM002324,AMS0073,9,6,1,8,30,45,D
AM002324,AMS0074,9,9,9,9,55,82,A
AM002324,AMS0075,9,7,1,19,46,73,A
AM002324,AMS0076,9,5,1,12,41,59,C
AM002324,AMS0077,9,10,0,14,56,80,A
AM002324,AMS0078,9,0,6,7,39,52,C
AM002324,AMS0079,9,9,0,3,35,47,D
AM002324,AMS0080,9,8,8,6,16,38,F
AM002324,AMS0081,9,6,5,2,58,71,A
AM002324,AMS0082,9,1,4,19,38,62,B
AM002324,AMS0083,9,5,10,18,26,59,C
AM002324,AMS0084,9,0,10,17,35,62,B
AM002324,AMS0085,9,0,4,18,0,22,F
AM002324,AMS0086,9,6,7,15,27,55,C
AM002324,AMS0087,9,4,10,0,40,54,C
AM002324,AMS0088,9,2,4,6,26,38,F
AM002324,AMS0089,9,9,6,2,33,50,C
AM002324,AMS0090,9,1,5,10,40,56,C
AM002324,AMS0091,9,6,6,14,37,63,B
AM002324,AMS0092,9,7,10,12,49,78,A
AM002324,AMS0093,9,7,4,13,26,50,C
AM002324,AMS0094,9,6,0,13,50,69,B
AM002324,AMS0095,9,0,3,12,16,31,F
AM002324,AMS0096,9,10,8,5,33,56,C
AM002324,AMS0097,9,6,5,13,27,51,C
AM002324,AMS0098,9,2,1,19,0,22,F
AM002324,AMS0099,9,0,6,12,20,38,F
AM002324,AMS0100,9,0,6,5,59,70,A
AM002324,AMS0101,9,2,4,1,14,21,F
AM002324,AMS0102,9,4,4,1,35,44,E
AM002324,AMS0103,9,3,3,11,57,74,A
AM002324,AMS0001,10,8,5,16,1,30,F
AM002324,AMS0002,10,9,3,11,10,33,F
AM002324,AMS0003,10,4,3,2,39,48,D
AM002324,AMS0004,10,1,2,8,16,27,F
AM002324,AMS0005,10,10,9,16,15,50,C
AM002324,AMS0006,10,9,10,14,44,77,A
AM002324,AMS0007,10,5,8,5,40,58,C
AM002324,AMS0008,10,1,0,17,47,65,B
AM002324,AMS0009,10,2,5,10,25,42,E
AM002324,AMS0010,10,5,0,15,56,76,A
AM002324,AMS0011,10,2,0,8,7,17,F
AM002324,AMS0012,10,10,1,8,30,49,D
AM002324,AMS0013,10,0,8,8,41,57,C
AM002324,AMS0014,10,3,6,15,41,65,B
AM002324,AMS0015,10,10,8,9,49,76,A
AM002324,AMS0016,10,7,5,10,23,45,D
AM002324,AMS0017,10,3,10,11,33,57,C
AM002324,AMS0018,10,8,3,19,52,82,A
AM002324,AMS0019,10,6,0,1,10,17,F
AM002324,AMS0020,10,7,0,1,14,22,F
AM002324,AMS0021,10,2,6,9,25,42,E
AM002324,AMS0022,10,7,5,11,56,79,A
AM002324,AMS0023,10,2,8,15,25,50,C
AM002324,AMS0024,10,5,7,12,48,72,A
AM002324,AMS0025,10,8,2,15,46,71,A
AM002324,AMS0026,10,2,8,2,36,48,D
AM002324,AMS0027,10,9,10,17,27,63,B
AM002324,AMS0028,10,7,0,11,52,70,A
AM002324,AMS0029,10,5,7,13,9,34,F
AM002324,AMS0030,10,5,6,20,56,87,A
AM002324,AMS0031,10,1,6,14,55,76,A
AM002324,AMS0032,10,1,10,16,10,37,F
AM002324,AMS0033,10,1,7,7,48,63,B
AM002324,AMS0034,10,9,3,9,18,39,F
AM002324,AMS0035,10,0,1,19,14,34,F
AM002324,AMS0036,10,6,0,8,21,35,F
AM002324,AMS0037,10,0,8,11,44,63,B
AM002324,AMS0038,10,5,6,4,52,67,B
AM002324,AMS0039,10,7,7,17,57,88,A
AM002324,AMS0040,10,7,2,2,12,23,F
AM002324,AMS0041,10,6,1,15,21,43,E
AM002324,AMS0042,10,5,1,4,9,19,F
AM002324,AMS0043,10,3,4,2,13,22,F
AM002324,AMS0044,10,7,2,2,27,38,F
AM002324,AMS0045,10,2,9,20,42,73,A
AM002324,AMS0046,10,8,5,5,52,70,A
AM002324,AMS0047,10,10,7,19,20,56,C
AM002324,AMS0048,10,0,10,20,44,74,A
AM002324,AMS0049,10,2,4,3,6,15,F
AM002324,AMS0050,10,5,10,10,55,80,A
AM002324,AMS0051,10,2,7,2,46,57,C
AM002324,AMS0052,10,2,10,2,1,15,F
AM002324,AMS0053,10,2,4,17,55,78,A
AM002324,AMS0054,10,6,1,20,44,71,A
AM002324,AMS0055,10,0,3,8,5,16,F
AM002324,AMS0056,10,7,2,11,54,74,A
AM002324,AMS0057,10,7,6,3,43,59,C
AM002324,AMS0058,10,1,1,8,22,32,F
AM002324,AMS0059,10,7,1,4,2,14,F
AM002324,AMS0060,10,5,0,13,38,56,C
AM002324,AMS0061,10,9,5,2,20,36,F
AM002324,AMS0062,10,8,0,11,53,72,A
AM002324,AMS0063,10,9,6,5,31,51,C
AM002324,AMS0064,10,0,10,19,36,65,B
AM002324,AMS0065,10,6,2,9,32,49,D
AM002324,AMS0066,10,2,1,3,28,34,F
AM002324,AMS0067,10,3,0,2,32,37,F
AM002324,AMS0068,10,4,5,19,55,83,A
AM002324,AMS0069,10,1,1,8,14,24,F
AM002324,AMS0070,10,2,10,7,42,61,B
AM002324,AMS0071,10,5,3,11,45,64,B
AM002324,AMS0072,10,4,3,3,46,56,C
AM002324,AMS0073,10,1,2,11,32,46,D
AM002324,AMS0074,10,6,1,7,2,16,F
AM002324,AMS0075,10,8,9,2,15,34,F
AM002324,AMS0076,10,5,10,3,12,30,F
AM002324,AMS0077,10,4,2,3,32,41,E
AM002324,AMS0078,10,7,10,18,17,52,C
AM002324,AMS0079,10,0,5,6,36,47,D
AM002324,AMS0080,10,6,2,8,19,35,F
AM002324,AMS0081,10,4,3,20,29,56,C
AM002324,AMS0082,10,8,9,2,36,55,C
AM002324,AMS0083,10,4,3,14,43,64,B
AM002324,AMS0084,10,3,0,7,53,63,B
AM002324,AMS0085,10,4,0,2,49,55,C
AM002324,AMS0086,10,7,8,1,39,55,C
AM002324,AMS0087,10,4,0,1,55,60,B
AM002324,AMS0088,10,8,4,4,19,35,F
AM002324,AMS0089,10,3,7,9,12,31,F
AM002324,AMS0090,10,9,3,8,49,69,B
AM002324,AMS0091,10,6,7,6,57,76,A
AM002324,AMS0092,10,10,4,16,2,32,F
AM002324,AMS0093,10,3,9,0,31,43,E
AM002324,AMS0094,10,8,10,4,42,64,B
AM002324,AMS0095,10,3,8,7,25,43,E
AM002324,AMS0096,10,5,10,15,46,76,A
AM002324,AMS0097,10,9,9,2,50,70,A
AM002324,AMS0098,10,1,9,14,49,73,A
AM002324,AMS0099,10,4,7,12,22,45,D
AM002324,AMS0100,10,2,9,12,52,75,A
AM002324,AMS0101,10,3,9,5,18,35,F
AM002324,AMS0102,10,2,10,19,41,72,A
AM002324,AMS0103,10,8,6,11,33,58,C
AM002324,AMS0001,11,1,5,14,42,62,B
AM002324,AMS0002,11,2,8,10,52,72,A
AM002324,AMS0003,11,6,5,5,20,36,F
AM002324,AMS0004,11,7,9,17,31,64,B
AM002324,AMS0005,11,1,4,7,14,26,F
AM002324,AMS0006,11,2,5,2,11,20,F
AM002324,AMS0007,11,8,0,10,5,23,F
AM002324,AMS0008,11,7,2,17,41,67,B
AM002324,AMS0009,11,4,6,18,18,46,D
AM002324,AMS0010,11,10,7,13,26,56,C
AM002324,AMS0011,11,1,10,5,46,62,B
AM002324,AMS0012,11,3,0,13,31,47,D
AM002324,AMS0013,11,4,5,17,12,38,F
AM002324,AMS0014,11,8,4,17,9,38,F
AM002324,AMS0015,11,1,6,16,18,41,E
AM002324,AMS0016,11,7,5,0,41,53,C
AM002324,AMS0017,11,9,1,12,41,63,B
AM002324,AMS0018,11,1,2,12,15,30,F
AM002324,AMS0019,11,10,6,1,21,38,F
AM002324,AMS0020,11,5,3,19,25,52,C
AM002324,AMS0021,11,10,7,7,26,50,C
AM002324,AMS0022,11,8,0,0,41,49,D
AM002324,AMS0023,11,1,10,16,43,70,A
AM002324,AMS0024,11,1,1,12,58,72,A
AM002324,AMS0025,11,5,2,1,56,64,B
AM002324,AMS0026,11,8,6,12,19,45,D
AM002324,AMS0027,11,8,5,9,30,52,C
AM002324,AMS0028,11,5,0,5,6,16,F
AM002324,AMS0029,11,9,6,0,35,50,C
AM002324,AMS0030,11,7,1,1,28,37,F
AM002324,AMS0031,11,10,6,6,20,42,E
AM002324,AMS0032,11,9,5,20,25,59,C
AM002324,AMS0033,11,5,7,4,27,43,E
AM002324,AMS0034,11,6,8,4,22,40,E
AM002324,AMS0035,11,3,7,5,28,43,E
AM002324,AMS0036,11,3,6,8,57,74,A
AM002324,AMS0037,11,0,6,13,7,26,F
AM002324,AMS0038,11,5,6,2,53,66,B
AM002324,AMS0039,11,9,5,13,50,77,A
AM002324,AMS0040,11,7,8,6,20,41,E
AM002324,AMS0041,11,7,9,17,49,82,A
AM002324,AMS0042,11,9,4,12,20,45,D
AM002324,AMS0043,11,3,1,11,49,64,B
AM002324,AMS0044,11,3,1,3,34,41,E
AM002324,AMS0045,11,3,3,8,16,30,F
AM002324,AMS0046,11,2,4,6,2,14,F
AM002324,AMS0047,11,10,5,13,8,36,F
AM002324,AMS0048,11,3,2,1,43,49,D
AM002324,AMS0049,11,1,7,9,35,52,C
AM002324,AMS0050,11,1,9,20,1,31,F
AM002324,AMS0051,11,8,1,20,54,83,A
AM002324,AMS0052,11,4,1,7,24,36,F
AM002324,AMS0053,11,5,8,14,54,81,A
AM002324,AMS0054,11,5,0,14,16,35,F
AM002324,AMS0055,11,10,5,16,57,88,A
AM002324,AMS0056,11,10,9,14,39,72,A
AM002324,AMS0057,11,0,1,14,42,57,C
AM002324,AMS0058,11,2,5,10,37,54,C
AM002324,AMS0059,11,9,4,13,21,47,D
AM002324,AMS0060,11,8,3,18,42,71,A
AM002324,AMS0061,11,4,1,7,0,12,F
AM002324,AMS0062,11,2,3,4,57,66,B
AM002324,AMS0063,11,7,4,3,9,23,F
AM002324,AMS0064,11,1,10,9,49,69,B
AM002324,AMS0065,11,6,8,20,12,46,D
AM002324,AMS0066,11,10,8,13,32,63,B
AM002324,AMS0067,11,3,0,3,10,16,F
AM002324,AMS0068,11,8,10,16,41,75,A
AM002324,AMS0069,11,10,1,20,13,44,E
AM002324,AMS0070,11,3,10,8,17,38,F
AM002324,AMS0071,11,6,4,17,0,27,F
AM002324,AMS0072,11,4,7,11,45,67,B
AM002324,AMS0073,11,1,7,20,46,74,A
AM002324,AMS0074,11,8,5,14,43,70,A
AM002324,AMS0075,11,0,8,4,0,12,F
AM002324,AMS0076,11,7,1,12,27,47,D
AM002324,AMS0077,11,3,3,8,24,38,F
AM002324,AMS0078,11,3,2,11,48,64,B
AM002324,AMS0079,11,9,4,1,2,16,F
AM002324,AMS0080,11,0,9,14,40,63,B
AM002324,AMS0081,11,9,6,4,26,45,D
AM002324,AMS0082,11,4,0,1,42,47,D
AM002324,AMS0083,11,8,7,16,8,39,F
AM002324,AMS0084,11,4,7,3,23,37,F
AM002324,AMS0085,11,3,5,5,41,54,C
AM002324,AMS0086,11,0,2,4,36,42,E
AM002324,AMS0087,11,6,9,12,10,37,F
AM002324,AMS0088,11,9,2,8,44,63,B
AM002324,AMS0089,11,7,4,4,33,48,D
AM002324,AMS0090,11,6,4,17,41,68,B
AM002324,AMS0091,11,10,5,14,51,80,A
AM002324,AMS0092,11,3,1,15,54,73,A
AM002324,AMS0093,11,5,7,0,24,36,F
AM002324,AMS0094,11,4,0,7,29,40,E
AM002324,AMS0095,11,3,6,13,25,47,D
AM002324,AMS0096,11,10,5,13,52,80,A
AM002324,AMS0097,11,6,2,4,23,35,F
AM002324,AMS0098,11,10,8,19,25,62,B
AM002324,AMS0099,11,3,4,7,34,48,D
AM002324,AMS0100,11,1,7,19,6,33,F
AM002324,AMS0101,11,10,1,9,49,69,B
AM002324,AMS0102,11,6,2,5,1,14,F
AM002324,AMS0103,11,6,2,16,18,42,E
AM002324,AMS0001,12,10,3,8,21,42,E
AM002324,AMS0002,12,2,10,7,43,62,B
AM002324,AMS0003,12,6,2,17,45,70,A
AM002324,AMS0004,12,8,9,6,3,26,F
AM002324,AMS0005,12,3,5,4,4,16,F
AM002324,AMS0006,12,6,10,1,51,68,B
AM002324,AMS0007,12,0,9,18,37,64,B
AM002324,AMS0008,12,8,6,12,34,60,B
AM002324,AMS0009,12,3,2,11,30,46,D
AM002324,AMS0010,12,0,5,3,32,40,E
AM002324,AMS0011,12,10,1,18,50,79,A
AM002324,AMS0012,12,4,10,5,17,36,F
AM002324,AMS0013,12,9,8,12,49,78,A
AM002324,AMS0014,12,5,8,13,5,31,F
AM002324,AMS0015,12,3,7,18,32,60,B
AM002324,AMS0016,12,6,5,6,14,31,F
AM002324,AMS0017,12,1,2,1,42,46,D
AM002324,AMS0018,12,10,7,17,20,54,C
AM002324,AMS0019,12,7,8,14,1,30,F
AM002324,AMS0020,12,1,0,13,53,67,B
AM002324,AMS0021,12,1,2,4,46,53,C
AM002324,AMS0022,12,1,3,2,31,37,F
AM002324,AMS0023,12,5,2,13,8,28,F
AM002324,AMS0024,12,9,6,3,6,24,F
AM002324,AMS0025,12,3,5,6,57,71,A
AM002324,AMS0026,12,4,9,6,44,63,B
AM002324,AMS0027,12,1,10,9,9,29,F
AM002324,AMS0028,12,6,6,5,23,40,E
AM002324,AMS0029,12,10,7,18,39,74,A
AM002324,AMS0030,12,7,2,5,49,63,B
AM002324,AMS0031,12,1,2,7,31,41,E
AM002324,AMS0032,12,10,9,17,60,96,A
AM002324,AMS0033,12,5,4,3,0,12,F
AM002324,AMS0034,12,9,10,19,36,74,A
AM002324,AMS0035,12,9,6,10,22,47,D
AM002324,AMS0036,12,10,3,18,50,81,A
AM002324,AMS0037,12,8,7,10,28,53,C
AM002324,AMS0038,12,3,9,16,12,40,E
AM002324,AMS0039,12,2,5,9,51,67,B
AM002324,AMS0040,12,7,0,12,54,73,A
AM002324,AMS0041,12,1,6,6,24,37,F
AM002324,AMS0042,12,4,5,9,53,71,A
AM002324,AMS0043,12,5,7,10,28,50,C
AM002324,AMS0044,12,4,6,20,7,37,F
AM002324,AMS0045,12,5,8,6,2,21,F
AM002324,AMS0046,12,5,7,20,43,75,A
AM002324,AMS0047,12,5,7,1,22,35,F
AM002324,AMS0048,12,9,1,11,2,23,F
AM002324,AMS0049,12,6,7,16,12,41,E
AM002324,AMS0050,12,9,3,14,26,52,C
AM002324,AMS0051,12,0,5,15,35,55,C
AM002324,AMS0052,12,3,0,11,34,48,D
AM002324,AMS0053,12,9,9,3,13,34,F
AM002324,AMS0054,12,9,8,12,42,71,A
AM002324,AMS0055,12,8,2,20,44,74,A
AM002324,AMS0056,12,7,9,15,51,82,A
AM002324,AMS0057,12,5,0,7,5,17,F
AM002324,AMS0058,12,3,6,2,50,61,B
AM002324,AMS0059,12,8,7,4,32,51,C
AM002324,AMS0060,12,9,7,10,15,41,E
AM002324,AMS0061,12,5,9,16,27,57,C
AM002324,AMS0062,12,4,6,1,32,43,E
AM002324,AMS0063,12,1,2,8,42,53,C
AM002324,AMS0064,12,2,3,19,25,49,D
AM002324,AMS0065,12,5,6,1,20,32,F
AM002324,AMS0066,12,6,6,11,16,39,F
AM002324,AMS0067,12,3,8,3,44,58,C
AM002324,AMS0068,12,4,1,13,50,68,B
AM002324,AMS0069,12,5,5,1,47,58,C
AM002324,AMS0070,12,2,5,14,1,22,F
AM002324,AMS0071,12,6,10,0,34,50,C
AM002324,AMS0072,12,2,9,17,9,37,F
AM002324,AMS0073,12,1,9,15,57,82,A
AM002324,AMS0074,12,4,0,4,60,68,B
AM002324,AMS0075,12,9,7,6,43,65,B
AM002324,AMS0076,12,6,4,18,22,50,C
AM002324,AMS0077,12,7,2,0,12,21,F
AM002324,AMS0078,12,6,3,8,43,60,B
AM002324,AMS0079,12,5,6,18,35,64,B
AM002324,AMS0080,12,8,6,6,13,33,F
AM002324,AMS0081,12,4,0,6,20,30,F
AM002324,AMS0082,12,5,0,13,55,73,A
AM002324,AMS0083,12,1,6,2,11,20,F
AM002324,AMS0084,12,9,7,9,31,56,C
AM002324,AMS0085,12,5,5,1,57,68,B
AM002324,AMS0086,12,8,10,0,43,61,B
AM002324,AMS0087,12,8,5,10,3,26,F
AM002324,AMS0088,12,2,5,1,22,30,F
AM002324,AMS0089,12,3,6,7,7,23,F
AM002324,AMS0090,12,7,3,20,13,43,E
AM002324,AMS0091,12,7,6,14,13,40,E
AM002324,AMS0092,12,2,2,16,34,54,C
AM002324,AMS0093,12,5,3,13,22,43,E
AM002324,AMS0094,12,4,10,3,58,75,A
AM002324,AMS0095,12,4,1,10,39,54,C
AM002324,AMS0096,12,5,4,18,24,51,C
AM002324,AMS0097,12,5,4,17,41,67,B
AM002324,AMS0098,12,1,9,1,3,14,F
AM002324,AMS0099,12,7,2,3,48,60,B
AM002324,AMS0100,12,2,3,14,11,30,F
AM002324,AMS0101,12,3,9,13,17,42,E
AM002324,AMS0102,12,8,0,1,33,42,E
AM002324,AMS0103,12,9,2,19,52,82,A
AM002324,AMS0001,13,9,6,18,38,71,A
AM002324,AMS0002,13,9,4,15,32,60,B
AM002324,AMS0003,13,5,5,3,13,26,F
AM002324,AMS0004,13,9,7,18,27,61,B
AM002324,AMS0005,13,6,0,2,24,32,F
AM002324,AMS0006,13,7,2,6,16,31,F
AM002324,AMS0007,13,5,9,18,36,68,B
AM002324,AMS0008,13,6,3,13,14,36,F
AM002324,AMS0009,13,3,7,14,49,73,A
AM002324,AMS0010,13,8,4,11,45,68,B
AM002324,AMS0011,13,10,5,19,18,52,C
AM002324,AMS0012,13,2,10,16,43,71,A
AM002324,AMS0013,13,3,2,6,33,44,E
AM002324,AMS0014,13,1,9,2,9,21,F
AM002324,AMS0015,13,5,4,1,44,54,C
AM002324,AMS0016,13,6,8,6,0,20,F
AM002324,AMS0017,13,4,9,14,8,35,F
AM002324,AMS0018,13,7,7,17,53,84,A
AM002324,AMS0019,13,10,7,19,1,37,F
AM002324,AMS0020,13,0,9,4,59,72,A
AM002324,AMS0021,13,5,1,17,31,54,C
AM002324,AMS0022,13,10,6,3,16,35,F
AM002324,AMS0023,13,3,2,7,29,41,E
AM002324,AMS0024,13,7,7,7,7,28,F
AM002324,AMS0025,13,7,0,5,22,34,F
AM002324,AMS0026,13,1,3,17,23,44,E
AM002324,AMS0027,13,3,6,1,4,14,F
AM002324,AMS0028,13,4,2,14,1,21,F
AM002324,AMS0029,13,2,6,4,58,70,A
AM002324,AMS0030,13,5,3,2,58,68,B
AM002324,AMS0031,13,3,8,9,34,54,C
AM002324,AMS0032,13,8,6,20,2,36,F
AM002324,AMS0033,13,10,5,6,15,36,F
AM002324,AMS0034,13,1,4,18,4,27,F
AM002324,AMS0035,13,8,5,11,3,27,F
AM002324,AMS0036,13,6,10,0,55,71,A
AM002324,AMS0037,13,8,5,18,37,68,B
AM002324,AMS0038,13,3,4,18,60,85,A
AM002324,AMS0039,13,7,5,9,17,38,F
AM002324,AMS0040,13,1,3,9,1,14,F
AM002324,AMS0041,13,7,9,0,31,47,D
AM002324,AMS0042,13,9,1,0,27,37,F
AM002324,AMS0043,13,1,6,18,55,80,A
AM002324,AMS0044,13,5,10,6,16,37,F
AM002324,AMS0045,13,5,7,2,32,46,D
AM002324,AMS0046,13,5,6,4,53,68,B
AM002324,AMS0047,13,2,2,6,28,38,F
AM002324,AMS0048,13,7,2,6,27,42,E
AM002324,AMS0049,13,2,5,18,5,30,F
AM002324,AMS0050,13,4,5,2,25,36,F
AM002324,AMS0051,13,8,1,18,57,84,A
AM002324,AMS0052,13,7,9,6,19,41,E
AM002324,AMS0053,13,7,9,5,0,21,F
AM002324,AMS0054,13,4,10,3,28,45,D
AM002324,AMS0055,13,6,10,6,45,67,B
AM002324,AMS0056,13,10,5,14,0,29,F
AM002324,AMS0057,13,9,10,17,28,64,B
AM002324,AMS0058,13,10,0,20,58,88,A
AM002324,AMS0059,13,2,3,3,11,19,F
AM002324,AMS0060,13,0,6,11,28,45,D
AM002324,AMS0061,13,10,1,11,37,59,C
AM002324,AMS0062,13,7,0,19,24,50,C
AM002324,AMS0063,13,6,3,6,31,46,D
AM002324,AMS0064,13,8,5,4,32,49,D
AM002324,AMS0065,13,7,2,17,5,31,F
AM002324,AMS0066,13,2,7,6,3,18,F
AM002324,AMS0067,13,9,9,15,46,79,A
AM002324,AMS0068,13,2,5,4,17,28,F
AM002324,AMS0069,13,2,1,20,36,59,C
AM002324,AMS0070,13,8,2,12,27,49,D
AM002324,AMS0071,13,0,10,17,53,80,A
AM002324,AMS0072,13,10,6,2,52,70,A
AM002324,AMS0073,13,9,10,8,37,64,B
AM002324,AMS0074,13,4,2,5,33,44,E
AM002324,AMS0075,13,3,8,18,22,51,C
AM002324,AMS0076,13,5,5,5,45,60,B
AM002324,AMS0077,13,3,8,14,21,46,D
AM002324,AMS0078,13,10,0,14,7,31,F
AM002324,AMS0079,13,3,6,0,59,68,B
AM002324,AMS0080,13,4,1,14,18,37,F
AM002324,AMS0081,13,8,9,10,40,67,B
AM002324,AMS0082,13,2,9,1,33,45,D
AM002324,AMS0083,13,2,3,17,16,38,F
AM002324,AMS0084,13,7,3,19,57,86,A
AM002324,AMS0085,13,2,1,19,18,40,E
AM002324,AMS0086,13,2,9,2,11,24,F
AM002324,AMS0087,13,10,6,5,56,77,A
AM002324,AMS0088,13,2,6,16,46,70,A
AM002324,AMS0089,13,4,9,10,30,53,C
AM002324,AMS0090,13,9,7,16,57,89,A
AM002324,AMS0091,13,3,5,11,22,41,E
AM002324,AMS0092,13,3,6,1,43,53,C
AM002324,AMS0093,13,2,8,3,49,62,B
AM002324,AMS0094,13,4,0,5,38,47,D
AM002324,AMS0095,13,5,4,10,7,26,F
AM002324,AMS0096,13,1,5,14,44,64,B
AM002324,AMS0097,13,0,6,8,24,38,F
AM002324,AMS0098,13,1,7,15,2,25,F
AM002324,AMS0099,13,4,1,4,32,41,E
AM002324,AMS0100,13,1,9,2,18,30,F
AM002324,AMS0101,13,6,3,5,17,31,F
AM002324,AMS0102,13,7,0,8,27,42,E
AM002324,AMS0103,13,4,5,10,54,73,A
AM002324,AMS0001,14,10,8,12,57,87,A
AM002324,AMS0002,14,9,7,10,15,41,E
AM002324,AMS0003,14,10,2,1,28,41,E
AM002324,AMS0004,14,7,0,13,11,31,F
AM002324,AMS0005,14,4,5,12,26,47,D
AM002324,AMS0006,14,2,3,16,59,80,A
AM002324,AMS0007,14,7,7,4,21,39,F
AM002324,AMS0008,14,0,6,5,14,25,F
AM002324,AMS0009,14,4,6,18,18,46,D
AM002324,AMS0010,14,7,9,4,8,28,F
AM002324,AMS0011,14,6,8,4,48,66,B
AM002324,AMS0012,14,0,4,18,47,69,B
AM002324,AMS0013,14,9,2,11,18,40,E
AM002324,AMS0014,14,4,3,15,18,40,E
AM002324,AMS0015,14,8,8,12,59,87,A
AM002324,AMS0016,14,8,1,17,41,67,B
AM002324,AMS0017,14,4,4,2,6,16,F
AM002324,AMS0018,14,0,6,7,12,25,F
AM002324,AMS0019,14,6,0,19,34,59,C
AM002324,AMS0020,14,9,4,1,51,65,B
AM002324,AMS0021,14,9,4,0,20,33,F
AM002324,AMS0022,14,1,2,6,21,30,F
AM002324,AMS0023,14,4,5,20,22,51,C
AM002324,AMS0024,14,10,10,17,24,61,B
AM002324,AMS0025,14,6,6,17,7,36,F
AM002324,AMS0026,14,10,5,12,29,56,C
AM002324,AMS0027,14,6,0,0,47,53,C
AM002324,AMS0028,14,9,2,6,34,51,C
AM002324,AMS0029,14,3,4,13,6,26,F
AM002324,AMS0030,14,3,9,14,58,84,A
AM002324,AMS0031,14,1,10,11,49,71,A
AM002324,AMS0032,14,6,8,4,3,21,F
AM002324,AMS0033,14,4,4,7,24,39,F
AM002324,AMS0034,14,8,8,10,17,43,E
AM002324,AMS0035,14,3,6,9,58,76,A
AM002324,AMS0036,14,9,3,14,37,63,B
AM002324,AMS0037,14,9,10,6,42,67,B
AM002324,AMS0038,14,7,8,12,48,75,A
AM002324,AMS0039,14,3,2,11,25,41,E
AM002324,AMS0040,14,1,1,16,7,25,F
AM002324,AMS0041,14,5,2,1,58,66,B
AM002324,AMS0042,14,10,3,12,15,40,E
AM002324,AMS0043,14,5,6,4,59,74,A
AM002324,AMS0044,14,3,10,15,32,60,B
AM002324,AMS0045,14,3,5,19,8,35,F
AM002324,AMS0046,14,5,5,12,30,52,C
AM002324,AMS0047,14,3,10,19,16,48,D
AM002324,AMS0048,14,9,10,5,23,47,D
AM002324,AMS0049,14,8,10,10,26,54,C
AM002324,AMS0050,14,5,6,10,41,62,B
AM002324,AMS0051,14,5,5,2,36,48,D
AM002324,AMS0052,14,6,10,10,35,61,B
AM002324,AMS0053,14,9,9,16,17,51,C
AM002324,AMS0054,14,6,4,12,35,57,C
AM002324,AMS0055,14,7,8,7,58,80,A
AM002324,AMS0056,14,2,0,16,8,26,F
AM002324,AMS0057,14,8,3,19,56,86,A
AM002324,AMS0058,14,7,10,5,17,39,F
AM002324,AMS0059,14,5,2,5,16,28,F
AM002324,AMS0060,14,9,5,20,2,36,F
AM002324,AMS0061,14,6,1,19,39,65,B
AM002324,AMS0062,14,8,9,12,2,31,F
AM002324,AMS0063,14,4,1,8,7,20,F
AM002324,AMS0064,14,7,10,15,47,79,A
AM002324,AMS0065,14,2,3,13,43,61,B
AM002324,AMS0066,14,0,1,20,32,53,C
AM002324,AMS0067,14,1,2,16,53,72,A
AM002324,AMS0068,14,8,5,9,4,26,F
AM002324,AMS0069,14,10,5,9,26,50,C
AM002324,AMS0070,14,2,4,4,41,51,C
AM002324,AMS0071,14,5,2,2,11,20,F
AM002324,AMS0072,14,7,0,19,55,81,A
AM002324,AMS0073,14,2,0,2,13,17,F
AM002324,AMS0074,14,0,2,11,29,42,E
AM002324,AMS0075,14,1,2,2,3,8,F
AM002324,AMS0076,14,9,6,11,5,31,F
AM002324,AMS0077,14,10,10,10,33,63,B
AM002324,AMS0078,14,4,10,5,57,76,A
AM002324,AMS0079,14,5,6,2,47,60,B
AM002324,AMS0080,14,6,2,8,7,23,F
AM002324,AMS0081,14,2,2,2,59,65,B
AM002324,AMS0082,14,10,0,19,28,57,C
AM002324,AMS0083,14,8,2,12,51,73,A
AM002324,AMS0084,14,1,8,0,8,17,F
AM002324,AMS0085,14,6,1,15,55,77,A
AM002324,AMS0086,14,4,4,4,1,13,F
AM002324,AMS0087,14,3,2,9,55,69,B
AM002324,AMS0088,14,1,8,2,38,49,D
AM002324,AMS0089,14,5,8,8,40,61,B
AM002324,AMS0090,14,1,4,3,50,58,C
AM002324,AMS0091,14,7,5,0,50,62,B
AM002324,AMS0092,14,2,9,15,5,31,F
AM002324,AMS0093,14,6,8,5,15,34,F
AM002324,AMS0094,14,8,8,3,33,52,C
AM002324,AMS0095,14,0,9,10,1,20,F
AM002324,AMS0096,14,0,9,3,53,65,B
AM002324,AMS0097,14,10,4,14,12,40,E
AM002324,AMS0098,14,5,2,18,16,41,E
AM002324,AMS0099,14,6,0,1,8,15,F
AM002324,AMS0100,14,9,10,4,9,32,F
AM002324,AMS0101,14,10,7,13,55,85,A
AM002324,AMS0102,14,0,2,17,55,74,A
AM002324,AMS0103,14,7,3,20,10,40,E
